LLLLLLLLLXLLLLLLLLLLLLLLLLXLLLLLLLLLLXLLLLLLLLLLLL
LLLLLXLLLLLLLLLLLLLLLLLLXLLLLLLLLLLLXXXXXXXLLLLLLX
LLLLLLLXLLLLLXLLLLLLLLLLLLLLLLLLLLXLXXXXXXXLLLLLLL
LLLLLLLLLLLLLLLLLLLXLLLLLLLLLLLLLLLLXXXXXXXLLLLLLL
LLLLLXLLLLLLLLLLLLLLLLLLLLXLLLLLLLLLXXXXXXXLLLLLLL
LLLLLLLLLLLLLLLLLLLLLLLLLLXLLLLLLLLLLLLLLLLLLLLLLL
LLLLLLLLLLLLXLLLLLLLLLLLLLXLLXLLLLLLLLLLLLLLLLLLLL
LLLLLLLLLLLLLLLLLLLLLLLLLLXLLLLLLLLLLLLLLLLLLLLLLL
LLLLLLLLLLLLLLLLLLLLLLLLLLLLLLLLLLLLXLLXLLLLLLLLLL
LLLLXLLLLLLLLLLLLLLLXLLLLLLLLLLLLLLLLLLLLLLLLLLLLL
LLLLLLLLLLLLLLLLLLLLLLLLLLLLLLLLLLLLLLLLLLLLLLLLLL
LLLLLLLLLLLLLLXLLLLLLLLLLLXXLLLLLLLLXLLLLLLLLLLLLL
LLLXLLLLLLLLLLLLLLLLLLLLLLLLLLLLLLLLLLLLLLLLLLXLLL
LLLLLLLLLXXLLLXXLLLLLLLLLLLXLLLLLLLLLLLLLLLLLLLLLL
LLLLLLLLLXPPPPPXLLLLLLLLLLLLLLLLLLLLLLLLLLLLLLLLLL
LLLLLLLLLLPPPPPLLLLLLLLLLLLLLLLLLLLXLLLLLLLLLLLLLL
LLLLLLLLLLPPSPPLLLLLLLLLXLLLLLLLLLLLLLLLLLLLLLLLLL
LLLLLLLLLLPPPPPLLLLLLLLLLLLLLLLLLLLLLLXLLLLLLLLLLL
LLLLLLLLLXPPPPPXLLLLLLXLLLLLLLLLLLLLLLLLLLXLLLLLLL
LLLLLLLLLXXLLLXXLLLLLLLLLLLLLLLXLLLLLLLLLLLLLLLLLL
LLLLLLLLLLLLLLLLLLLLLLLLXLLLLLLLLLLLLLLLLLLLLXLLLL
XLLLLLLLLLLLLLLLLLXLLLLLLLLLLLLLLLLLLLLLXLLLLLLLLL
LLLLLLLLLLLLLLLLLLLLLLLLLLLLLLLXLLLLLLLLLLLLLLLLLL
LLLLLXLLLLLLLLLLLXLLLLLLLLLLLLLLLLLLLLLLLLLLLLLLLL
LLLLLLLLLLLLLLLLLLLLLLLLLLLLXLLLLLLLLLLXLLLLLLLLLL
LLXLLLLLLLLLLLLXLLLLXLLLLLLLLLLXLLLLLLLLLLLLLLLLLL
LLLLLLLLLLLLLLLLLLLLLLLLLLLLLLLLLLLLLXLLLLLLLLLLLL
LLLLLLXLLLLLLLLLLLLXLLLLLLLLLLLLLLXLLLLLLLLLLLLLLL
LLLLLLLLLLLXLLLLLLLLLLLLLXLLLLLLLLLLLLLLLXLLLLLLLL
XXLLLLLLLLLLLLLLLLLLLXLLLLLLLLLLLLLLLLLLLLLLLLLLLL
LXXLLLLLLLLLLLLLLLLLLLLLLLLLLXLLLLLLLXLLLLLLLLLLLL
LLXXLLLLLLLLLXXXXLLXXXXXLLXXXXLLLLLLLLLLLLLLLLLLLL
LLLLXLLLLLLLLLLLLLLLLLLLLLLLLLLLLLLLLLLLLLXLLLLLLL
LLLLLXLLLLLLLLLLLLXLLLLLLLXLLLLLLLLLLLLLLLLLLLLLLL
LLLLLLXLLLXLLLLLLLLLLLLLLLLLLLLLLLLLLXLLLLLLLLLXLL
LLLLLLXLLLLLLLLLLLLLLLLXLLLLLLLLXLLLLLLLLLLLLLLLLL
LLLLLLXLLLLXLLXLLXLLLLLXLLLLLXLLLLLLLLLLLLXLLLLLLL
LLLLLXLLXLLLLLLLLLLLLLLLLLXLLLLLLLLLLLLLXLLLLLLLLL
LLLLXXLLLLLLLLXLLLLXLLLLLLLLLLLLLLXLLLLLLLLLLLXLLL
LLXXLLLLLLLXLLLLLXLLLLLLLXLLXLLXXLLLLLXLLLLLLLLLLL
XXLLLLXLLLLLLXLLLLLXLLLLLXLLLLLXLLLLLXLLLLXLLLLXLL
LLLLLLLLLLLLLLLLLXLLLLLLLLXLLLLLLLLLLLLLLLLLLLLLLL
LLLLLLLLLXLLLLLLLLLLLLLLLLLLLLLLLLLLLLLLLLLLLXLLLL
LLLLLLLLLLLLLLLLLLLLLLLLLLLLXLLLLLLLXXXXXXXXXXXXXX
LLLLLXLLLLLLLLLLXLLLLLLLLLLLLLLLLLLLXPPPPPPPPPPPPP
LLLLLLLLLLLLLLLLLLLLLLLLLLLLLLLLLLLLXPPPPPPPPPPPPP
LLLLLLLLLLLLLLLLLLLLLLLLLLLXLLLLLLLLLPPPPPPPPPPPPP
LLLLLLLLLLXLLLLLLLLLLXLLLLLLLLLLLLLLXPPPPPPPPPPPPP
LLLLLLLLLLLLLLLLLLLLLLLLLXXLLLLLLLLLXPPPPPPPPPPPPP
LLXLLLLLLLLLLLLLLXLLLLLLLLLLLLLLLLLLXPPPPPPPPPPPPP
